1111111111111111E1111
111110000011100000111
111110000000000000111
111110000000000000111
000000000000000000111
000110000011100000000
000111000111110001110
110111000111110001110
110111000111110001110
110000000011100000000
111110000000000000111
111110000000000000111
1111S0000000000000111
111110000011100000111