111111111111111111111
100000000000000000001
100000000000010101001
100001000000010101001
100001000000010101001
111111000000000000101
S0000000000100000000E
100000000001000000001
100000000111110000001
100000000001000000001
100000000001000011111
100000000000000000001
100000000000000000001
111111111111111111111